
WWWWWWWWWWWWWWWWWWWWWWWWWWWWWWWWWW
W00000000000000000000000000000000W
W00000000000000000000000000000000W
W00000000000000000000000000000000W
W00000000000000000000000000000000W
W00000000000000022222222200000000W
W00000000000000000000000000000000W
W00000000000000000000000000000000W
W00000222222222220000000001111000W
W00000000000000000000000000000000W
W000000000000000000000000000000000
W10D00000111100000001111000000D000
W11111111111111111111111111111111W
W11111111111111111111111111111111W
WWWWWWWWWWWWWWWWWWWWWWWWWWWWWWWWWW



					
WWWWWWWWWWWWWWWWWWWWWWWWWWWWWWWWWWW00WWWW
W000000000000000000000000000000000000000W					
W000000000000000000000000000000000000000W
W000000000000000000000000000000000000000W
W0000000000000000000000000000000000000000
W000000000000000000000000000000000000D000
W000000000000000000000001111111111111111W
W000000000000000000000001111111111111111W
W000000000002200111111111111111111111111W
W000000000000000111111111111111111111111W
W000000000000000111111111111111111111111W
W000000000000000111111111111111111111111W
W000022000000000111111111111111111111111W
W000000000000000111111111111111111111111W
W000000002200000111111111111111111111111W
W000000000000000111111111111111111111111W
W000000000000000W11111111111111111111111W
W0D0000000000000W11111111111111111111111W
W111111111111111111111111111111111111111W
W111111111111111111111111111111111111111W
WWWWWWWWWWWWWWWWWWWWWWWWWWWWWWWWWWWWWWWWW






WWWWWWWWWWWWWWWWWWWWWWWWWWWWWWWWWWWWWWWWWWWWWWWWWWWWWW00WWWWWWWWW
W000000000000000000000000000000000000000000000000000000000000000W
W000000000000000000000000000000000000000000000000000000000000000W
W000000000000000000000000000000000000000000000000000000000000000W
W000000000000022000000000000220000000000000002200000000022000000W
W000000000000000000000000000000000000000000000000000000000000000W
W000000000000000000000000000000000000000000000000000000000000000W
W0D0000000000000000000000000000000000000000000000000000000000D00W
W111111111111111111111111111111111111111111111111111111111111111W
W111111111111111111111111111111111111111111111111111111111111111W
WWWWWWWWWWWWWWWWWWWWWWWWWWWWWWWWWWWWWWWWWWWWWWWWWWWWWWWWWWWWWWWWW

