1111111111111111111111111111111111111111111111111111111111111
1                                                           1
1                                                           1
1                                                           1
1							    1
1							    1
1							    1
1	  22			    22			    1
1							    1
1		 2222222222		  22222222	    1
2222222222222222211111111112222222222222221111111122222222222
1111111111111111111111111111111111111111111111111111111111111
1111111111111111111111111111111111111111111111111111111111111
1111111111111111111111111111111111111111111111111111111111111
1111111111111111111111111111111111111111111111111111111111111
1111111111111111111111111111111111111111111111111111111111111