0000000111122211110000000000000000
0000000000000000000000000000000000
0000000000000000000000000000000000
0000000000000000222222222000000000
0000000000000000000000000000000000
0000000000000000000000000000000000
0000002222222222200000000011110000
0000000000000000000000000000000000
0000000000000000000000000000000000
0100000001000000000000010000000000
0000000000000110000001110000000000
0000010111111111100111111000011111
1111111111111111111111111111111111





    