WWWWWWWWWWWWWWWWWWWWW
W0000000000000000000W
W0000000000000000000W
W0000000000000000000W
W00000D0000000000C00W
W00000000000000C0110W
WWWWWWWWWWWWWWWWWWWWW