WWWWWWWWWWW
W000000000W
W000000000W
W000000000W
W00000D000W
W000000000W
WWWWWWWWWWW